text,sentences_count,characters_count,repeated_letters_count,spaces_count,chars_excl_spaces_count,repeated_spaces_count,whitespaces_count,chars_excl_whitespaces_count,repeated_whitespaces_count,count_words,duplicates_count,emoji_count,repeated_digits_count,whole_numbers_count,alpha_numeric_count,non_alpha_numeric_count,punctuations_count,repeated_punctuations_count,stop_words_count,dates_count,noun_phase_count
I love ‚öΩ very much üòÅ.,1,21,0,5,16,0,5,16,0,4,0,2,0,0,13,8,1,0,1,0,3
2833047 people live in this area. It is not a good area.,2,56,0,11,45,0,11,45,0,11,2,0,1,1,43,13,2,0,5,0,4
2833047 and 1111 people live in this area.,1,42,0,7,35,0,7,35,0,6,0,0,2,2,34,8,1,0,3,0,2
Harrington PPPPPPpppppeople work hard. I think they have a goodd traittttt.,2,75,3,10,65,0,10,65,0,11,1,0,0,0,63,12,2,0,3,0,5
283047 people live in this area3333 22224444,1,44,0,6,38,0,6,38,0,4,0,0,3,3,38,6,0,0,2,0,2
"This sentence does not seem to have too many commas, periods or semicolons (;).",1,79,0,13,66,0,13,66,0,13,0,0,0,0,61,18,5,0,6,0,5
283047 people live in this area[[[ ]]] :::;;;;,1,46,0,7,39,0,7,39,0,5,4,1,0,1,26,20,13,4,2,0,7
"The date today is 04/28/2020 for format mm/dd/yyyy, not 28/04/2020.",1,67,1,9,58,0,9,58,0,10,0,0,0,6,50,17,8,0,3,1,4
The date today is 28/04/2020 and tomorrow's date is 29/04/2020.,1,63,0,9,54,0,9,54,0,9,2,0,0,6,48,15,6,0,3,2,4
Everyone here works so hard. People work hard. I think they have a good trait.,3,78,0,14,64,0,14,64,0,15,2,0,0,0,61,17,3,0,5,0,5
283047   people live in this  area,1,34,0,8,26,2,8,26,2,5,0,0,0,1,26,8,0,0,2,0,2
"2833047 pe
ople li	ve in this area",1,35,0,5,30,0,8,27,0,8,0,0,1,1,27,8,0,0,3,0,6
"2833047   people

   live in   th
is are		a",1,45,0,11,34,3,18,27,6,7,0,0,1,1,27,18,0,0,4,0,2
